0000000000000000000000000000000000000
0   0   0   0   0   0   0   0   0   0
0 S 0   0   0   0   0   0   0   0   0
0   0   0   0   0   0   0   0   0   0
0000000000000000000000000000000000000
0   0   0   0   0   0   0   0   0   0
0   0   0   0   0   0   0   0   0   0
0   0   0   0   0   0   0   0   0   0
0000000000000000000000000000000000000
0   0   0   0   0   0   0   0   0   0
0   0   0   0   0   0   0   0   0   0
0   0   0   0   0   0   0   0   0   0
0000000000000000000000000000000000000
0   0   0   0   0   0   0   0   0   0
0   0   0   0   0   0   0   0   0 E 0
0   0   0   0   0   0   0   0   0   0
0000000000000000000000000000000000000