############################################
##  ######  ####    ####        ##        ##
##    ##    ##  ####  ########  ##  ########
##  ##  ##  ##        ######  ####      ####
##  ######  ##  ####  ####  ######  ########
##  ######  ##  ####  ##        ##        ##
############################################